12 7
1 1 1 1 3 3 3 1 1 1 1 1
1 2 2 1 1 3 1 0 0 0 11 1
1 0 0 7 0 1 0 0 0 0 0 1
1 0 0 0 0 6 0 0 0 0 0 1
1 9 0 0 0 0 0 0 2 2 1 1
1 0 4 4 4 4 0 0 5 5 10 1
1 1 1 1 1 1 1 1 1 1 1 1
+
0 0 0 0 0 0 0 0 0 0 0 0
0 0 0 0 0 0 0 0 0 0 0 0
0 7 4 0 0 0 0 2 5 0 0 0
0 7 0 0 0 2 0 1 0 3 8 0
0 0 6 6 0 0 0 0 0 0 0 0
0 0 0 0 0 0 0 8 8 0 0 0
0 0 0 0 0 0 0 0 0 0 0 0
+
3
9 10
10 11
11 9
