12 8
1 9 1 1 1 1 1 1 1 2 0 1
1 0 1 0 0 1 0 0 0 2 4 1
1 0 1 0 0 1 0 7 7 1 10 1
1 0 1 0 0 1 0 0 0 1 2 1
1 0 1 0 0 0 0 0 0 1 2 1
1 11 12 0 0 0 0 0 0 1 0 1
1 4 0 0 0 0 0 0 4 1 13 1
1 1 1 1 1 1 1 1 1 1 1 1
+
0 0 0 0 0 0 0 0 0 7 0 0
0 0 0 7 0 0 0 0 0 7 0 0
0 2 0 0 0 0 8 8 8 0 0 0
0 8 0 0 0 0 0 0 0 0 2 0
0 0 0 2 0 0 0 0 0 0 0 0
0 0 0 8 8 2 8 8 8 0 1 0
0 0 0 0 0 0 0 0 0 0 0 0
0 0 0 0 0 0 0 0 0 0 0 0
+
5
9 10
10 12
11 13
12 10
13 11
Nevena Sreckovic
