12 7
2 2 2 2 6 6 6 2 2 2 2 2
2 5 5 2 2 6 2 0 0 0 6 2
2 0 0 0 0 2 0 0 0 0 0 2
2 0 0 0 0 0 0 0 0 0 0 2
2 4 0 0 0 0 0 0 0 0 2 2
2 0 7 7 7 7 0 0 0 0 4 2
2 2 2 2 2 2 2 2 2 2 2 2
+
0 0 0 0 0 0 0 0 0 0 0 0
0 0 0 0 0 0 0 0 0 0 0 0
0 0 4 0 0 0 0 2 0 0 0 0
0 0 0 0 0 2 0 0 0 3 0 0
0 11 6 6 0 0 0 0 0 0 0 0
0 0 0 0 0 0 0 1 0 0 12 0
0 0 0 0 0 0 0 0 0 0 0 0
+
2
11 12
12 11
