12 13
1 1 1 1 1 3 3 1 1 1 1 1
1 9 0 0 1 3 3 1 0 0 10 1
1 0 0 0 1 1 1 1 0 0 0 0
1 0 0 0 0 1 1 0 0 0 0 1
1 0 0 0 0 2 2 0 0 0 4 1
1 1 1 0 0 1 1 0 0 1 1 1
3 3 1 1 0 0 0 0 1 1 3 3
1 1 1 0 0 1 1 0 0 1 1 1
1 4 0 0 0 1 1 0 0 0 0 1
1 0 0 0 0 2 0 0 0 4 0 0
1 0 0 0 1 1 1 1 0 0 0 1
1 11 0 0 1 3 3 1 0 0 12 1
1 0 0 1 1 3 3 1 1 0 1 1
+
0 0 0 0 0 0 0 0 0 0 0 0
0 0 0 0 0 0 0 0 0 0 0 0
0 0 2 0 0 0 0 0 0 0 0 0
0 0 0 0 0 0 0 0 0 0 1 0
0 0 4 0 8 0 0 0 0 0 0 0
0 0 0 0 0 0 0 0 7 0 0 0
0 0 0 0 0 0 0 0 0 0 0 0
0 0 0 0 0 0 0 0 0 0 0 0
0 0 0 0 0 0 0 0 7 0 0 0
0 0 0 0 0 8 8 0 0 7 0 0
0 0 2 0 0 0 0 0 0 0 0 0
0 0 0 0 0 0 0 0 0 0 0 0
0 0 0 0 0 0 0 0 0 0 0 0
+
4
9 11
10 9
11 12
12 11
