11 11
1 1 1 2 2 1 1 2 2 2 2
1 2 1 2 2 0 2 2 4 1 2
1 2 1 2 2 0 2 2 2 2 2
1 2 2 2 2 2 2 2 2 2 1
2 2 2 2 2 2 2 2 2 2 1
2 2 2 2 2 2 2 0 0 2 2
2 2 2 2 2 2 2 0 0 2 2
2 2 2 0 2 2 0 2 2 2 2
2 2 2 0 2 2 0 2 4 2 2
1 2 1 1 2 2 0 1 1 2 1
2 2 2 2 2 2 2 2 2 2 2
+
0 0 0 0 0 0 0 0 0 0 0
0 1 0 0 7 8 0 0 0 0 0
0 0 0 0 2 8 0 0 0 0 0
0 0 0 0 0 0 0 0 0 0 0
0 0 0 0 0 0 0 0 0 0 0
0 0 0 0 0 0 0 0 0 0 0
0 0 0 0 0 0 0 0 0 0 0
0 0 2 8 0 0 8 0 0 0 0
0 0 7 8 0 0 8 0 0 0 0
0 0 0 0 0 0 8 0 0 0 0
0 0 0 0 0 0 0 0 0 0 0
+
0
Nevena Sreckovic