10 10
1 1 1 3 3 3 3 3 3 3
3 0 0 0 0 0 0 0 0 3
3 0 0 0 0 1 0 0 0 3
3 0 0 0 0 1 0 0 0 3
3 0 0 0 0 0 0 0 0 3
3 3 0 2 3 3 8 3 3 3
3 0 0 0 0 0 0 0 0 3
3 4 0 0 0 0 0 0 0 3
3 4 4 4 0 0 0 0 0 3
3 3 3 3 3 3 3 3 3 3
+
0 0 0 0 0 0 0 0 0 0
0 1 0 0 0 0 0 0 0 0
0 0 0 2 2 0 0 0 0 0
0 0 0 2 0 0 0 0 0 0
0 0 0 0 0 0 0 0 0 0
0 0 8 8 0 0 0 0 0 0
0 0 0 0 0 0 0 0 0 0
0 0 0 0 0 0 0 2 0 0
0 0 0 0 0 0 8 3 7 0
0 0 0 0 0 0 0 0 0 0
+
0
Crtomir Osep
