14 11
3 3 3 3 3 3 3 3 3 3 3 3 3 3
3 0 0 0 0 0 0 0 0 3 0 0 0 3
3 0 0 0 0 0 0 0 0 3 0 0 4 3
3 0 0 0 0 0 0 0 0 5 0 4 1 3
3 0 0 0 0 0 0 0 0 3 0 0 4 3
3 0 0 0 0 0 0 0 3 3 0 4 1 3
3 1 1 1 0 1 1 0 3 3 0 0 4 3
3 0 0 0 0 0 1 0 0 3 10 0 0 3
3 0 9 0 0 0 0 0 0 3 0 0 0 3
3 3 3 3 3 3 3 3 3 3 3 3 3 11
3 3 3 3 3 3 3 3 3 3 3 3 3 0
+
0 0 0 0 0 0 0 0 0 0 0 0 0 0
0 0 0 0 0 0 0 0 0 0 0 0 0 0
0 0 0 0 2 2 0 2 0 0 0 0 0 0
0 1 0 0 0 2 0 0 8 0 0 0 0 0
0 0 0 0 2 0 0 0 0 0 0 0 0 0
0 0 7 0 0 0 0 0 0 0 0 0 0 0
0 0 0 0 8 0 0 0 0 0 0 0 0 0
0 0 0 0 0 0 0 0 0 0 0 0 0 0
0 0 0 0 0 0 0 0 0 0 0 0 0 0
0 0 0 0 0 0 0 0 0 0 0 0 0 0
0 0 0 0 0 0 0 0 0 0 0 0 0 0
+
3
9 10
10 11
11 10
