11 11
1 1 1 1 1 1 1 1 1 1 1
1 4 0 0 0 1 0 0 0 9 1
1 0 1 0 0 1 1 10 0 0 0
1 0 1 11 1 1 0 0 0 0 0
1 12 1 0 0 1 0 0 0 4 0
1 1 1 1 1 3 1 1 1 1 1
1 13 0 0 0 1 4 0 0 0 1
1 0 0 0 14 1 0 0 0 0 1
1 0 1 0 0 1 15 0 0 0 1
1 4 4 0 0 1 0 0 16 0 1
1 1 1 1 1 1 1 1 1 1 1
+
0 0 0 0 0 0 0 0 0 0 0
0 0 0 0 0 0 0 0 0 0 0
0 1 0 2 0 0 0 0 0 0 0
0 2 0 0 0 0 0 0 0 2 0
0 0 0 0 0 0 0 0 0 0 0
0 0 0 0 0 0 0 0 0 0 0
0 0 0 0 0 0 0 0 0 0 0
0 0 0 0 0 0 0 2 0 0 0
0 0 0 0 2 0 0 0 0 0 0
0 0 0 0 0 0 0 0 0 0 0
0 0 0 0 0 0 0 0 0 0 0
+
8
9 16
10 11
11 10
12 13
13 12
14 15
15 14
16 9
